20
####################
#oooooooo##oooooooo#
#o##o#oooooooo#o##o#
#o##o#o######o#o##o#
#o#oo#o#oooo#o#oo#o#
#o#oo#ooo##ooo#oo#o#
#oooooo#oooo#oooooo#
#o##o#o######o#o##o#
#oo#o#oooooooo#o#oo#
##o#o#o##__##o#o#o##
##o#o#o#_P__#o#o#o##
#oo#o#o######o#o#oo#
#o##o#ooo##ooo#o##o#
#oooooo#o##o#oooooo#
####o###o##o###o####
##oooooooooooooooo##
##o##############o##
##o#oooooooooooo#o##
##ooo##oo##oo##ooo##
####################
