20
####################
#Gooooooo##oooooooG#
#o##o###o##o###o##o#
#o##o###o##o###o##o#
#oooooooooooooooooo#
#o##o#o######o#o##o#
#oooo#o#o##o#o#oooo#
#o##o#ooo##ooo#o##o#
#oo#o###o##o###o#oo#
#o##o#oooooooo#o##o#
#oo#o#o##__##o#o#oo#
#o##o#o#_G__#o#o##o#
#oooooo######oooooo#
#o##o#oooPoooo#o##o#
#oo#o#o######o#o#oo#
##o#ooooo##ooooo#o##
#oo#o###o##o###o#oo#
#o#oooooooooooooo#o#
#ooo##oo#oo#oo##ooo#
####################
