11
###########
#Poooooooo#
#o##o#o##o#
#o#oo_oo#o#
#o##o_o##o#
#oooo#oooo#
#o##o_o##o#
#o#oo_oo#o#
#o##o#o##o#
#ooooooooo#
###########
