20
####################
#oooooooooooooooooo#
#o#######__#######o#
#o#oooooooooooooo#o#
#o#oo_########_oo#o#
#o#o_oooooooooo_o#o#
#o#o#o###__###o#o#o#
#o#o#o#oooooo#o#o#o#
#o#o#o#o####o#o#o#o#
#o_o#o_o#Pooo_o#o_o#
#o_o#o_oooo#o_o#o_o#
#o#o#o#o####o#o#o#o#
#o#o#o#oooooo#o#o#o#
#o#o#o###__###o#o#o#
#o#o_oooooooooo_o#o#
#o#oo_########_oo#o#
#o#oooooooooooooo#o#
#o#######__#######o#
#oooooooooooooooooo#
####################
