10
##########
#P_______#
#_##__##_#
#_#____#_#
#________#
#________#
#_#____#_#
#_##__##_#
#________#
##########
