5
#####
#P_o#
#_o_#
#o_o#
#####
